jan	january
Jan	january
JAN	january
feb	february
Feb	february
FEB	february
mar	march
Mar	march
MAR	march
apr	april
Apr	april
APR	april
jun	june
Jun	june
JUN	june
jul	july
Jul	july
JUL	july
aug	august
Aug	august
AUG	august
sep	september
Sep	september
SEP	september
sept	september
Sept	september
SEPT	september
oct	october
Oct	october
OCT	october
nov	november
Nov	november
NOV	november
dec	december
Dec	december
DEC	december
