january	january
february	february
march	march
april	april
may	may
june	june
july	july
august	august
september	september
october	october
november	november
december	december
January	january
JANUARY	january
February	february
FEBRUARY	february
March	march
MARCH	march
April	april
APRIL	april
June	june
JUNE	june
July	july
JULY	july
August	august
AUGUST	august
September	september
SEPTEMBER	september
October	october
OCTOBER	october
November	november
NOVEMBER	november
December	december
DECEMBER	december
